1111111111111111111111111111111
1111111110000000000011111111111
1110000000000000000000000111111
1100000000000000000000000001111
1000000000000000000000000000111
1000000000010000000000000000011
1000000111010010011110000000111
1111111111111111111111111111111
%
