1111111111111111111111111111111111111111111111111111111111111111
1100011111100000110000001111000000000000001100000000000001111111
1000011110000000000000000000000000000000000000000000000000000111
1000011111000000000000000000000000000000000000000000000000000011
1000011111100001111000000000000100000000000000000000000000000011
1100000111111000000000111111110001111001111111111000000001111111
1110000000000000000011111111111111110000011111000000000011011111
1111000000000000001111100000000000000000000000000010111110001111
1111111110000001111111110000000000000000000000000110001000000111
1111111111111111111110000000000000000000000000000000000000000011
1111111100000000000000000000000011111110011111111000000000011111
1111100000000000000000000000000110111111111111111111111111111111
1000000000000000000000000000000111111111111111111111111111111111
1000000000000000000000000000111111111111111111111111111111111111
1000000000010101010010010100111111111111111111111111111111111111
1111111110010000000000000000111111111111111111111111111111111111
1111111111111111111111111111111111111111111111111111111111111111
%
